11111111111111111111111111111111111111111111111111
11111111001000110000101000100011001000110010000011
10100110101100001011010110110010101100110011010011
10110110001100101001000000110011001101111011100101
10010000001101101011000010110101101100101001000001
10110100101101110001000000010111101101000011011111
10110110101100101001011110110110101100001011110001
10110100101101101011001010010111101100100011001011
10110110001101001011101100110010101110010011110011
10010111101001101010101010100110000101111011101111
10110100101110010011001010110011001110010011000011
10110110101100101001011110000101000100011001000111
10000101000100011001000110010000001001101011000011
10110010001100101001000000110001001111001001000001
10100110101100001011110000110100101101101011001011
10010000001001010010001010100111001001110010110011
10000101000100011001000110010000001001100011011111
10110011101101001011011100010000000100000001000001
10011110001101101011000010111100001101001011011011
10110010100101110011010100110010101101110011011101
10111100101000000011001010111000001101001011101001
10110010101100011011010000010111001100101011101011
10011111000001010001000110010001100001010001000111
10010001100100000010100110111010001100001011100101
10111010001100101011001000010000001101111011011101
10010000000100000010101000111010101100101001000001
10100111001101111011101100010000000110010001100101
10010000000110001001101000011101000110100001101001
10011101000110100001110000010000000110010001100001
10011000100110110001000000100110101100001011110001
10110100101101101011001010010000001001010010001011
10100111001001110010110010000101000100011001000111
10010000001001100011000010111001101110100001000001
10111010101110000011001000110000101110100011001011
10010000001010111011001010110010000100000010001001
10110010101100011001000000011001000111000001000001
10011001000110001001110100011001000110001001110101
10011001100110110001000000011001000110000001100011
10011011000100000010011010110000101111000011010011
10110110101100101001000000100101001000101010011101
10100111001011001000010100010001100100011000010101
10000101001010011010100100100001100100000001111011
10010000001101101011000010110100101101110001011101
10110001100001001010111000000101000001001000010011
10000100101101101011110010101111101110011011101001
10111001001011111011101000110111101011111011101111
10110111101110010011001000111010001100001011000101
10010111001100011000010010101110000001010000010011
10000100100001001011011010111100101011111011001111
10110010101110100011011100110001001110010001011101
10110001100001001010111000000101000001001000010011
10000100101101111011100000110010101101110010111111
10111011101101001011011100110010001101111011101111
10010111001100011000010010101110000001010000010011
10000100100001001011001000111001001100001011101111
10101111101101101011010010110111001101001011011011
10110000101110000001011100110001100001001010111001
10000101000001001000010010000100101110011011100101
10110001100101111011011010111100101011111011100001
10111010101110100010111110111000001101001011110001
10110010101101100001011100110001100001001010111001
10000101000001001000010010000100101110011011100101
10110001100101111011011010111100101011111011001001
10111001001100001011101110101111101101100011010011
10110111001100101001011100110001100001001010111001
10000101000001001000010010000100101110011011100101
10110001100101111011011010110111101110110011001011
10101111101100110011011110111001001110111011000011
10111001001100100001011100110001100001001010111001
10000101000001001000010010000100101110011011100101
10110001100101111011100100110000101111001011000111
10110000101110011011101000010111001100011000010011
10101110000001010000010010000100100001001011101111
10110111101101100011001100010111001100011000010011
10101110000001010000010010000100100001001011001011
10111011001100101011011100111010000101110011000111
10000100101011100000010100000100100001001000010011
10110110101111001010111110110010001110010011000011
10111011101011111011011000110100101101110011001011
10101111101110100011101110110111100101110011000111
10000101000001010010011100100000101001101010001011
10000100100111101000010010111011101101111011011001
10110011000110011011001000000101000001010010011111
10100001001001010000010010011110100001001001001001
10010100001010011010100100100001100111010001011101
10110001100111101001011100110111100101001000010101
10000101001000110010011000100000101000111010100111
10000100100111101000010010010110101101100011011011
10010000000101101011011000110001101011111011001111
10111001001100001011100000110100001011111011100001
10111001001101111011001110010000000101101010101111
10010000000101101010101110110010101111000011101001
10111001001100001001000000010110101010111011000011
10110110001101100001000000010110101010111011001011
10111001001110010011011110111001000100000001011011
10111000001100101011001000110000101101110011101001
10110100101100011000010100000101001000011010001101
10100110001000001010001110101001100100000001010111
10011110100100000001011010100100100101110001011111
10110100101101110011000110110110001110101011001001
10110010100100000001011010110011100001010000010101
10110000101101100011011000011101000001001001001001
10010100001001110010000010100110101000101001010011
10000101000001010001001000010100001001110010000011
10100110101000101001010010011101000100000001001001
10010100001001111010000100100101000101001000010101
10000100100001001011001110110001101100011001000001
10010110101101111001000000010010000101000010011101
10100000101001101010001010010100100100000001001001
10010100001001111010000100100101000101001001000001
10010010000101000010001100100110001000001010001111
10101001100101001000010100000101001100011011011001
10110010101100001011011100011101000001010000010011
10000100101110010011011010010000000101101011001101
10010000000100100001010000100111101000010010010101
10010100100001010000010100110011001100011011011001
10110010101100001011011100011101000001001011000111
10110110001100101011000010110111000001010000010011
10000100101110010011011010010000000101101011001101
10010000000100100001010000100111001000001010011011
10100010100101001000010100000101001110010011001011
10011101000001001011001100110001101101100011001011
10110000101101110001000000110000101101100011011001
11111111111111111111111111111111111111111111111111
